4 4
7 / 3 + 3 / 8
-   *   -   -
5 + 9 / 6 * 2
/   *   +   /
30 - 5 - 2 - 4
-   +   *   +
4 + 1 + 1 * 6
2 0
81
