4 4
5 - 8 - 2 - 2
/   +   *   -
9 / 1 / 4 / 7
+   -   +   *
4 * 1 + 3 + 3
*   *   +   -
5 - 6 / 6 + 56
3 3
125
