4 4
3 + 7 + 1 - 6
/   -   *   *
5 * 4 - 9 - 2
-   *   -   -
6 + 4 * 5 / 28
/   /   /   +
2 + 3 + 1 + 8
2 3
19
