4 4
9 + 1 * 8 - 3
-   -   +   +
3 * 7 - 2 * 5
*   /   *   /
6 / 2 / 1 + 5
-   -   -   +
6 / 4 + 4 + 56
3 3
109
