4 4
3 - 64 + 5 / 1
+   +   -   +
5 * 8 * 3 / 6
+   +   *   *
9 / 2 - 1 - 6
*   -   -   -
4 + 7 / 2 / 4
0 1
42
