4 4
4 - 4 + 6 - 8
*   +   /   +
5 - 2 * 5 - 7
/   /   -   +
6 - 2 + 75 / 1
+   -   *   *
1 / 3 * 9 + 3
2 2
11
