4 4
4 / 2 * 6 - 1
+   -   +   +
5 - 7 * 3 / 2
+   /   -   *
4 * 6 * 9 - 7
-   +   -   +
3 / 5 / 1 + 8
1 1
143
