4 4
6 - 7 * 2 + 8
+   *   -   /
2 - 6 / 4 + 3
/   *   -   /
5 * 4 * 9 - 3
+   -   +   /
1 - 64 + 1 + 5
3 1
149
