4 4
31 + 4 / 8 + 5
-   +   +   *
2 - 1 * 1 + 5
/   /   *   *
9 / 7 - 3 / 4
+   *   +   -
6 - 3 - 2 - 6
0 0
12
