4 4
6 + 3 - 1 + 7
+   /   *   /
6 - 4 - 1 + 4
-   -   /   -
2 / 4 * 9 * 5
+   -   +   +
2 / 8 * 3 * 5
1 3
119
