4 4
5 - 9 - 7 + 8
*   /   /   /
4 - 3 - 1 * 4
-   /   *   -
6 - 73 + 1 + 3
*   *   /   +
2 + 5 + 6 + 2
2 1
9
