4 4
4 - 9 / 3 + 6
+   +   *   +
1 * 1 - 8 - 5
/   *   -   *
2 + 96 / 4 * 5
+   /   /   -
7 + 3 - 6 - 2
2 1
6
