4 4
1 + 3 * 5 + 8
+   *   *   -
6 / 7 / 4 / 3
*   -   /   -
2 + 1 - 9 * 6
-   *   +   +
4 + 3 + 6 - 2
0 1
20
