4 4
9 - 7 - 3 - 3
-   *   *   +
61 + 1 + 1 / 6
-   *   +   -
2 / 2 * 8 / 4
*   -   +   /
5 + 6 / 5 + 4
1 0
44
