4 4
7 - 54 * 2 * 2
/   +   -   +
1 * 1 / 4 / 8
+   /   +   /
3 * 6 - 6 - 9
*   -   -   +
4 - 3 + 5 + 5
0 1
100
