4 4
7 - 3 * 9 * 8
*   *   +   +
3 + 3 / 1 / 5
+   -   /   -
4 * 2 + 1 + 2
+   -   -   +
5 / 6 - 4 - 6
0 1
31
