4 4
4 - 3 - 2 + 3
*   /   *   /
8 * 1 + 4 - 2
+   *   +   *
7 / 7 - 5 - 5
+   /   +   /
9 + 1 - 6 - 6
2 0
104
