4 4
5 - 6 / 8 + 6
*   /   -   /
5 + 3 * 2 - 3
-   -   *   *
1 * 4 / 1 - 2
/   -   +   +
7 + 9 + 4 + 16
3 3
80
