4 4
3 - 51 + 4 - 3
-   -   /   *
2 + 4 / 5 + 2
-   -   *   *
6 * 6 * 5 - 7
+   +   /   /
9 / 8 + 1 + 1
0 1
137
