4 4
8 + 5 - 9 - 7
*   /   +   +
5 + 2 * 2 / 6
-   +   -   *
4 / 4 + 1 * 3
+   -   /   -
6 / 1 - 3 * 13
3 3
100
