4 4
1 + 6 * 6 - 2
+   *   /   +
8 / 96 + 4 / 3
+   *   -   *
3 + 7 / 5 + 1
-   -   /   *
4 - 9 - 5 - 2
1 1
23
