4 4
7 - 4 * 2 + 8
+   +   /   -
6 - 38 * 1 * 1
-   *   -   /
2 / 4 * 9 - 6
-   +   /   /
5 + 5 + 3 + 3
1 1
12
