4 4
1 * 46 - 2 - 8
+   *   -   -
5 / 9 + 3 * 1
*   *   /   -
6 + 2 + 7 + 4
-   /   /   +
3 + 6 - 5 / 4
0 1
148
