4 4
6 - 8 + 9 / 1
*   -   *   +
1 - 2 * 4 * 7
+   -   -   /
4 * 5 - 6 - 2
+   /   /   /
5 + 3 + 77 + 3
3 2
125
