4 4
4 - 7 / 4 + 1
/   *   +   *
3 - 8 + 1 + 3
/   /   +   *
2 + 2 + 5 * 46
/   -   *   -
9 - 6 - 6 - 5
2 3
20
