4 4
7 + 4 * 4 - 9
/   +   +   /
37 - 6 + 6 / 8
+   /   /   -
2 + 1 * 2 + 5
-   *   *   -
1 - 3 - 5 * 3
1 0
5
