4 4
8 * 7 / 3 * 3
-   -   -   +
6 + 6 * 1 - 5
-   /   *   -
5 * 4 - 9 / 1
/   /   +   +
2 + 2 + 4 + 4
3 3
6
