4 4
9 - 1 * 4 + 1
-   /   +   +
6 * 6 - 7 * 8
+   -   -   /
2 - 3 / 66 - 2
/   /   *   *
4 + 5 + 3 + 5
2 2
138
