4 4
2 / 1 / 7 + 5
-   -   +   -
2 * 9 * 5 * 4
*   -   *   -
4 + 3 / 9 - 1
+   +   /   -
8 + 3 / 6 + 6
1 1
129
