4 4
7 * 8 / 5 * 4
+   +   +   +
6 * 4 - 9 - 6
+   +   *   +
3 * 2 - 50 - 2
/   /   /   /
3 - 1 - 5 - 1
2 2
16
