4 4
4 + 2 * 1 * 4
-   +   -   -
6 / 5 / 8 / 6
+   /   +   *
7 / 5 - 2 - 20
*   -   +   *
9 - 3 + 1 + 3
2 3
138
