4 4
3 / 4 * 4 - 2
+   -   -   *
3 - 1 / 1 + 8
-   *   /   -
5 / 5 + 7 + 2
-   /   *   +
9 + 3 * 6 + 6
1 0
32
