4 4
4 / 3 + 8 - 1
+   /   -   *
6 * 1 / 3 / 4
/   -   +   +
9 - 2 * 79 * 2
-   *   +   +
6 - 7 + 5 - 5
2 2
4
