4 4
5 / 2 + 3 * 8
+   *   +   -
5 * 1 + 4 / 6
+   *   *   +
68 / 2 + 1 / 6
-   -   -   /
7 - 4 - 9 - 3
2 0
28
