4 4
8 / 1 + 2 * 7
-   /   -   -
3 / 3 * 5 + 52
/   +   *   +
1 + 5 * 4 + 9
*   /   -   +
6 - 4 - 2 - 6
1 3
96
