4 4
9 * 6 * 7 / 3
+   +   +   +
1 + 67 + 1 / 6
-   /   *   +
4 / 8 / 2 * 3
*   -   -   -
4 - 2 - 5 - 5
1 1
12
