4 4
8 + 1 / 6 / 5
/   -   +   -
3 + 6 * 3 + 1
/   /   *   *
9 - 5 - 4 + 4
+   *   +   *
7 - 2 - 5 - 2
3 2
24
