4 4
1 - 2 + 1 * 3
/   +   /   +
8 + 4 + 2 / 5
-   *   +   *
6 / 6 - 4 - 7
-   *   /   +
5 * 3 - 9 - 7
2 3
12
