4 4
6 - 1 / 9 * 6
+   /   +   +
3 - 2 * 7 * 1
+   +   *   *
5 - 3 / 8 + 2
+   /   /   -
4 - 4 - 5 - 2
2 3
144
