4 4
1 / 2 + 4 / 2
+   *   -   -
3 * 5 / 3 / 36
-   +   /   +
8 - 7 * 8 - 1
-   -   *   *
4 + 6 + 5 + 6
1 3
17
