4 4
7 - 3 + 9 / 5
/   *   -   +
5 - 6 - 6 - 8
-   -   +   /
1 / 50 / 4 * 3
*   +   +   +
4 + 1 * 2 * 2
2 1
10
