4 4
4 * 5 - 7 + 2
-   +   /   +
9 * 6 / 8 + 4
+   /   *   -
1 / 1 + 2 / 6
*   +   -   *
5 - 3 - 3 - 3
3 2
64
