4 4
6 - 7 * 6 + 66
*   *   -   *
8 + 4 / 6 / 2
/   /   -   -
9 + 1 - 1 - 2
/   -   *   +
5 + 7 + 4 + 3
0 3
18
