4 4
9 * 3 - 5 * 8
+   +   +   +
15 + 5 / 2 + 4
-   +   -   /
4 * 7 * 1 / 3
*   /   -   -
6 - 2 - 1 / 6
1 0
4
