4 4
6 + 8 / 4 * 4
/   *   +   -
2 + 2 - 6 / 7
*   /   *   *
3 - 5 / 5 + 44
-   -   -   -
9 + 3 + 1 + 1
2 3
31
