4 4
1 / 3 * 6 - 5
-   -   *   +
8 / 14 + 7 + 9
-   -   *   *
4 - 4 * 3 / 6
/   /   -   +
2 + 2 + 1 + 5
1 1
5
