4 4
8 - 3 * 6 + 45
*   /   +   +
2 * 3 / 6 * 5
-   +   -   /
5 / 9 - 4 / 2
*   +   +   -
4 - 7 + 1 - 1
0 3
20
