4 4
4 - 1 / 5 - 16
+   *   /   *
7 / 3 / 8 - 2
*   -   -   +
1 + 3 - 2 * 6
*   +   -   +
5 + 9 + 4 / 6
0 3
93
