4 4
6 / 4 - 6 + 2
-   /   +   -
4 * 7 * 8 + 1
+   -   +   -
5 * 3 / 7 * 1
-   -   +   +
2 * 3 / 5 / 9
2 2
125
