4 4
2 * 1 / 2 + 9
+   -   +   +
7 * 73 * 6 * 5
-   -   *   +
1 / 6 / 3 + 8
+   -   /   /
4 - 4 - 5 - 3
1 1
29
