4 4
5 - 9 / 8 / 6
*   /   -   -
3 - 4 + 4 / 2
/   *   +   /
7 - 6 + 5 - 3
+   -   +   *
1 + 2 * 1 + 37
3 3
20
