4 4
9 - 6 * 6 - 7
*   +   /   /
3 * 4 / 2 - 3
+   /   -   *
1 / 2 * 8 - 5
-   -   +   +
4 + 1 + 5 + 60
3 3
6
