4 4
74 - 5 + 7 - 9
*   /   *   *
3 / 1 + 5 * 4
-   -   /   -
8 + 4 + 6 * 1
/   +   +   /
2 + 6 - 3 - 2
0 0
55
