4 4
10 + 6 - 3 * 2
-   -   /   -
9 * 3 - 7 - 8
*   -   *   /
5 + 5 * 2 + 4
+   +   /   +
6 / 4 / 1 + 1
0 0
37
