4 4
6 / 4 + 9 * 18
+   -   *   -
1 - 1 * 7 + 3
+   /   +   *
6 * 4 / 8 + 3
/   +   -   /
2 - 2 - 5 - 5
0 3
5
