4 4
2 + 7 * 2 - 1
*   +   +   -
5 - 4 * 8 - 7
/   -   -   -
1 * 5 * 3 / 6
+   /   +   +
4 + 3 / 9 / 6
0 1
38
