4 4
5 + 9 / 1 - 3
+   +   *   -
66 + 6 * 5 * 8
+   /   +   /
2 + 3 / 4 / 7
-   *   *   -
4 - 6 - 2 - 1
1 0
96
