4 4
6 + 2 / 5 - 5
/   /   /   +
3 - 4 + 9 - 1
+   -   /   +
1 - 64 * 7 - 8
-   *   *   +
3 * 4 + 6 * 2
2 1
128
