4 4
6 * 3 - 4 * 9
-   /   /   -
1 - 4 / 8 + 5
-   /   -   +
3 - 1 * 7 * 2
+   *   +   /
13 + 6 + 2 + 5
3 0
8
