4 4
6 + 4 - 5 + 8
/   *   /   -
6 / 1 - 5 * 2
+   *   /   -
7 * 9 * 2 - 12
/   -   -   +
5 + 1 + 9 + 7
2 3
120
