4 4
4 * 1 / 1 + 9
+   +   /   -
2 / 3 / 2 + 3
*   /   -   *
39 + 6 + 7 + 4
-   -   -   *
6 - 5 * 5 - 8
2 0
75
