4 4
3 / 3 * 1 / 9
-   +   +   +
8 * 7 / 4 - 5
/   +   +   /
6 * 61 - 1 - 6
+   *   *   +
4 - 2 - 2 - 5
2 1
113
