4 4
5 - 6 - 4 / 9
-   +   +   +
1 / 6 * 2 / 7
-   *   *   -
85 * 3 - 8 - 5
+   *   /   +
4 + 3 / 2 + 1
2 0
128
