4 4
2 + 1 + 3 - 3
/   +   *   *
8 * 1 / 6 + 4
+   +   *   /
5 / 4 * 7 + 6
/   -   -   -
5 - 6 - 2 - 9
2 3
9
