4 4
3 + 4 / 8 + 7
+   /   /   /
6 * 5 + 1 * 5
*   -   /   +
40 - 6 - 4 + 9
*   *   +   -
3 - 2 - 2 - 1
2 0
111
