4 4
8 * 5 / 2 - 3
+   +   -   -
4 * 2 - 9 / 6
/   +   *   /
5 + 6 * 3 - 16
+   *   -   -
4 / 1 + 1 + 7
2 3
31
