4 4
5 * 7 + 6 * 5
+   /   +   -
23 + 2 / 1 - 4
*   *   *   -
4 - 2 + 8 / 1
+   +   /   /
6 - 9 - 3 - 3
1 0
53
