4 4
2 - 8 - 3 - 7
+   +   +   +
2 * 9 / 5 - 1
/   /   -   +
64 + 1 * 3 * 5
-   *   /   *
4 - 6 / 6 + 4
2 0
13
