4 4
1 * 2 * 6 - 1
-   +   +   /
9 * 8 - 2 - 7
/   *   *   +
4 - 35 - 6 + 3
-   /   +   /
4 / 5 + 3 + 5
2 1
4
