4 4
6 + 9 - 1 - 7
/   *   *   *
2 - 3 + 3 + 5
+   -   +   +
2 / 6 * 55 * 5
+   /   /   -
4 - 1 / 8 - 4
2 2
115
