4 4
7 * 4 + 2 * 3
+   +   /   -
5 - 1 / 24 + 3
+   /   *   +
5 + 2 / 9 / 1
*   *   -   -
6 - 6 - 4 - 8
1 2
72
