4 4
3 - 9 * 3 + 7
-   /   /   *
8 - 6 / 6 - 4
+   +   +   *
5 + 4 / 1 * 5
/   +   *   -
2 - 2 - 1 + 47
3 3
32
